1111111111111
100100C0000C1
110P011111001
100000E000001
1000000000001
1111111111111