NO				./asset/textures/wall_n.xpm
SO			    			./ass et/textures/wall_s.xpm
WE	    	 ./asset/textures/aksdfjklasjflkasjkldfajsf.xpm
EA                 ./asset/cub/test01.cub
F 220,100,0
C 225,30,0
1111111111111111111111111
1000000000110000000000001
10110000011100000000000001
10010S0000!0000000000000111111111
11111111101a1000001110000000000001
100000000011000001110111111111111
11110111111111011100000010001
11110111111111011101010010001
11000000110101011100000000001
10000000000000001100000030001
10000000000000001101010010001
11000001110101011111011110N0111
11110111 1110101 101111010001
11111111111111111111111111111