NO ./asset/textures/wall_n.xpm
SO ./asset/textures/wall_s.xpm
WE ./asset/textures/wall_w.xpm
EA ./asset/textures/wall_e.xpm
F 220,100,0
C 225,30,0   11
1111111111111001
100000000000001111111111111111
1000000000000001
111111111111111100000000000001
               111111111111111