NO ./asset/textures/wall_n.xpm
SO ./asset/textures/wall_s.xpm
WE ./asset/textures/wall_w.xpm
EA ./asset/textures/wall_e.xpm
F 220,100,0
C 225,30,0
1111111111111111111111111111111111
1N11111111111111111111111111111111
1000111111111111111111111111111111
1110111111111111111111111111111111
1110011111111111111111111111111111
1111001111111111111111111111111111
1111111111111111111111111111111111